{
    "bgColour": 1,
    "size": { "width":14, "height":18 },
    "brickVariants":
    [
        1,1,2,1,1,1,2,2,2,1,2,1,2,1,
        1,2,1,2,1,2,1,2,1,2,1,2,1,2,
        2,2,1,2,1,2,1,1,1,2,2,2,1,2,
        1,1,0,2,2,0,1,1,0,2,2,0,1,1,
        0,0,2,0,0,1,0,0,2,0,0,1,0,0,
        0,2,1,0,1,2,0,0,1,1,2,2,1,0,
        0,0,0,0,0,0,0,0,0,0,0,0,0,0,
        0,0,0,0,0,0,0,0,0,0,0,0,0,0,
        0,0,0,0,0,0,0,0,0,0,0,0,0,0,
        0,0,0,0,0,0,0,0,0,0,0,0,0,0,
        0,0,0,0,0,0,0,0,0,0,0,0,0,0,
        0,0,0,0,0,0,0,0,0,0,0,0,0,0,
        0,0,0,0,0,0,0,0,0,0,0,0,0,0,
        0,0,0,0,0,0,0,0,0,0,0,0,0,0,
        0,0,0,0,0,0,0,0,0,0,0,0,0,0,
        0,0,0,0,0,0,0,0,0,0,0,0,0,0,
        0,0,0,0,0,0,0,0,0,0,0,0,0,0,
        0,0,0,0,0,0,0,0,0,0,0,0,0,0
    ],
    "brickColours":
    [
        6,5,7,3,5,2,1,8,9,7,6,6,3,7,
        1,2,1,2,1,2,1,2,1,2,1,2,1,2,
        1,6,7,9,4,3,5,2,7,0,9,8,3,5,
        1,1,0,2,2,0,1,1,0,2,2,0,1,1,
        0,0,2,0,0,1,0,0,2,0,0,1,0,0,
        3,4,5,5,4,2,9,6,4,7,3,6,4,2,
        0,0,0,0,0,0,0,0,0,0,0,0,0,0,
        9,9,0,10,10,0,9,9,0,10,10,0,9,9,
        0,0,11,0,0,12,0,0,11,0,0,12,0,0,
        0,0,0,0,0,0,0,0,0,0,0,0,0,0,
        0,0,0,0,0,0,0,0,0,0,0,0,0,0,
        0,0,0,0,0,0,0,0,0,0,0,0,0,0,
        0,0,0,0,0,0,0,0,0,0,0,0,0,0,
        0,0,0,0,0,0,0,0,0,0,0,0,0,0,
        0,0,0,0,0,0,0,0,0,0,0,0,0,0,
        0,0,0,0,0,0,0,0,0,0,0,0,0,0,
        0,0,0,0,0,0,0,0,0,0,0,0,0,0,
        0,0,0,0,0,0,0,0,0,0,0,0,0,0
    ]
}