{
    "bgColour": 0,
    "size": { "width":11, "height":6 },
    "brickVariants":
    [
        1,1,2,1,1,1,2,2,2,1,2,
        1,2,1,2,1,2,1,2,1,2,1,
        2,2,1,2,1,2,1,1,1,2,2,
        1,1,0,2,2,0,1,1,0,2,2,
        0,0,2,0,0,1,0,0,2,0,0,
        0,2,1,0,1,2,0,0,1,1,2
    ],
    "brickColours":
    [
        5,6,4,2,4,1,6,8,9,6,3,
        5,4,2,6,2,1,0,7,5,4,3,
        5,6,7,9,5,4,2,6,8,2,4,
        5,7,3,1,7,9,6,4,2,6,4,
        5,7,8,5,3,2,4,6,7,2,2,
        4,5,8,6,3,5,7,2,1,0,6
    ]
}