{
    "bgColour": 1,
    "size": { "width":14, "height":18 },
    "brickVariants":
    [
        1,1,2,1,1,1,2,2,2,1,2,1,2,1,
        1,2,1,2,1,2,1,2,1,2,1,2,1,2,
        2,2,1,2,1,2,1,1,1,2,2,2,1,2,
        1,1,0,2,2,0,1,1,0,2,2,0,1,1,
        0,0,2,0,0,1,1,1,2,0,0,1,0,0,
        0,2,1,0,1,115,101,101,115,1,2,2,1,0,
        0,0,0,0,0,0,0,0,0,0,0,0,0,0,
        0,0,0,0,0,0,0,0,0,0,0,0,0,0,
        0,0,0,0,0,0,0,0,0,0,0,0,0,0,
        0,0,0,0,0,0,0,0,0,0,0,0,0,0,
        0,0,0,0,0,0,0,0,0,0,0,0,0,0,
        0,0,0,0,0,0,0,0,0,0,0,0,0,0,
        0,0,0,0,0,0,0,0,0,0,0,0,0,0,
        0,0,0,0,0,0,0,0,0,0,0,0,0,0,
        0,0,0,0,0,0,0,0,0,0,0,0,0,0,
        0,0,0,0,0,0,0,0,0,0,0,0,0,0,
        0,0,0,0,0,0,0,0,0,0,0,0,0,0,
        0,0,0,0,0,0,0,0,0,0,0,0,0,0
    ]
}